#######################
#..........#..........#
#B###.####.#.####.###B#
#.###.####.#.####.###.#
#.....................#
#.###.#.#######.#.###.#
#.....#....#....#.....#
#####.####.#.####.#####
    #.####.#.####.#
    #.#.........#.#
    #.#.#######.#.#
#####.#.-     -.#.#####
........#     #........
#####.#.#     #.#.#####
    #.#.#     #.#.#
    #.#.#######.#.#
    #.#.........#.#
#####.#.#######.#.#####
#..........#..........#
#.###.####.#.####.###.#
#B..#.............#..B#
###.#.#.#######.#.#.###
#.....#....#....#.....#
#.########.#.########.#
#.....................#
#######################